20 20
129	0	0	0	0	0	0	0	0	0	0	0	0	0	0	0	0	0	0	0
65	193	65	129	0	0	0	0	0	0	0	0	0	0	0	0	0	0	0	0
0	129	0	129	0	0	0	0	0	0	0	0	0	0	0	0	0	0	0	0
0	129	0	129	0	0	0	0	0	0	0	0	0	0	0	0	0	0	0	0
0	129	0	129	0	0	0	0	0	0	0	0	0	0	0	0	0	0	0	0
0	65	65	65	65	65	65	193	65	65	65	65	65	129	0	0	0	0	0	0
0	0	0	0	0	0	0	129	0	0	0	0	0	129	0	0	0	0	0	0	
0	0	0	0	0	0	0	129	0	0	0	0	0	129	0	0	0	0	0	0
0	0	0	0	0	129	257	257	0	0	0	0	0	129	0	0	0	0	0	0
0	0	0	0	0	129	0	0	0	0	0	0	0	129	0	0	0	0	0	0
0	0	0	0	0	129	0	0	0	65	65	65	65	65	65	65	129	0	0	0
0	0	0	0	0	129	0	0	0	33	0	0	0	0	0	0	129	0	0	0
0	0	0	0	0	129	0	0	0	33	0	0	0	0	0	0	129	0	0	0
0	0	0	0	0	129	0	0	0	33	0	0	0	0	0	0	129	0	0	0
0	0	0	0	0	129	0	0	0	33	0	0	0	0	0	0	129	0	0	0
0	0	0	0	0	65	65	65	65	33	0	0	0	0	129	257	257	0	0	0
0	0	0	0	0	0	0	0	0	0	0	0	0	0	129	0	0	0	0	0
0	0	0	0	0	0	0	0	0	0	0	0	0	0	129	0	0	0	0	0
0	0	0	0	0	0	0	0	0	0	0	0	0	0	65	65	65	65	65	129	
0	0	0	0	0	0	0	0	0	0	0	0	0	0	0	0	0	0	0	1